0000000000000000000000000000000010010000000000000000000000000000000000
0000000000000000000000000000000010010000000000000000000000000000000000
0000011111111111000000000000000010010000000000000000000000000000000000
0000110000000001111111111111111110011111111111110000000000000000000000
0001100000000000000000000000000000000000000000011111111111110000000000
0001000000000000000000000000000000000000000000000000000000011111000000
0001000000000000000000000000000000000000000000000000000000000001111000
0001000000000000000000000000000000000000000000000000000000000000001000
0001000000000000000000000000000000000000000000000000000000000000001000
0001000000000000000000000000000000000000000000000000000000000000001000
0001000001110000000000000000000000000000000000000000000000000000001000
0001000001010000000000000000000000000000000000000000111000000000001000
0001001111011110000000000000000000000000000000000000101111100000001000
0001001000000010000000000000000000000000000000000011100000100000001000
0001000000000001110000000000000000000000000000000010000000111000001000
0001001000000000010000000000000000000000000000000110000000001100001000
0001001111000000000000000000000000000000000000000100000000000100001000
0001000001000000010000000000000000000011000000000100000000000100001000
0001000001000011110000000000110011100001000000000100000000000100001000
0001000001000010000000000000010011111111000000000100000000000100001000
0001000001000010000000000000110011111100110000000100000000000100001000
0001000000110110000000000111100011110000110000000110000000000100001000
0001000000000000000000000000000002000000000000000010000000000110001000
0001000000000000000000000000000000000111111100000010000000000010001000
0001100000000000000000000000000000000100000100000010000000000010001000
0000100000000000000000001111111000000100000100000010000000000010001000
0000100000000000000000001000001000000100000100000010000000000010001000
0000100000000000000000001000001000000100000100000010000000000010001000
0000100000000000000000001000001000000100000100000010000001111110001000
0000100000000000000000001000001000000100000100000010000001000000001000
0000100000000000000000001000001000000100000100000011111111000000001000
0000100000000000000000001000001000000100000100000000000000000000001000
0000100000000000000000001000001000000100000100000000000000000000001000
0000100000000000000000001000001000000100000100000000000000000000001000
0001100000000000000000001000001000000111111100000000000000000000001000
0001000000000000000000001000001000000000000000000000000000000000001000
0001000000000000000000001111111000000000000000000000000000000000001000
0001000000011111110000000000000000000000000000000000000000000000001000
0001000000011111110000000000000000000000000000000000000000000000001000
0001000000011111110000000000000000000000000000000000000000000000001000
0001000000011111110000000000000000000000000000000000000000000000001000
0001000000011111110000000000000000000000000000000000000000000000001000
0001000000011111110000000000000000000000000000000000000000000000001000
0001100000011111110000000000000000000000000000000000000000000000001000
0000111100000000000000000000000000000000000000000000000000000000001000
0000000100000000000000000000000000000000000000011110000000001100001000
0000000100000000000011111111000000000111111111110011100011111111111000
0000000111111111111110000001000000111100000000000000111110000000000000
0000000000000000000000000001111111100000000000000000000000000000000000
0000000000000000000000000000000000000000000000000000000000000000000000
