1111111111111111111111111111111111111111111111111111111111111111111111
1111111111111111111111111111111111144111111111111111111111111111111111
1111111111111111111111111111111111144111111111111111111111111111111111
1000000000000000000000000000000000000000000000000100000001111111111111
1110000000010000000000000000000000000000000000000000100001111111111111
1111100001000000000000000000000000000000000000000000010100111111111111
1111100000100000000000000000000000000000000000000000000000111111111111
1111100000000000000000000000000000000000000000000000010100111111111111
1111101001000000000000000000000000000000000000000000001000011111111111
1111000000000000100000000000000000000000000000001110100010001111111111
1111000000000000000000000000000000000000000000001110000000010111111111
1110000000000000011100000000000000000000000000000000001000100011111111
1110000000000000011111100000000000000000000000000000000000000001111111
1110000101110111000011101110000000000000000000000000000000000001111111
1110000001110111000000001110000000000000000000000001000000000000111111
1111000000000000111000000000000000000000000000000000000000000000111111
1111100001110000111011101110000000000000000000000000000000000000011111
1111100001110111000011101110000000000000000000000000000000000000001111
1111000000000111000000000000000000000000000000000000000000000000001111
1111000001110000000011100000001100000000000000000000000000000000001111
1110000001110000000011101110008810000100000000010000000000000000000111
1110000000000111000000001110000000300000000000000000000000000000000111
1110000001110111000011100000000000000000000000000000000000000000000111
1110000001110000111011101110000000000000000000111111111111110000001111
1100000000000000111000001110000000000000000000111111111117111000001111
0000000000000000000000000000000000011000000000000000000000000000001111
0000000001110111000000000000000000011000000111000000000000000000001111
1110000001110111000000000000000000000000000111000000000000000000001111
1111000000000000000000000000000000000000000000000111011100000000001111
1111000001110111000111011110000000000000000001110111011101110000000111
1111000001110111000111011110000000000000000001110000000001110000000111
1111001110000000000000000000000000000000000000000000000000000000000111
1110001110000000000000000000000000000000011100000111011100001110000011
1100000001110111000111001110000011100111011101110111011100001110000111
1100000001110111000111001110000011100111000001110000000001110000000111
1100000000000000000000000000000000000000000000000000000001110000000011
1100000001110111000111000000000011100111001110001110111000000000000111
1100011101110111000111011100000011100111001110001110111001110000010111
1100011100000000000000011100000000000000000001110000000001110001000111
1110000001110111011100000000000111100000000001110000000000000000000011
1110000001110111011101110001110111100011101110001110111000000010000111
1101110000000000000001110001110000000011101110001110111011100000001111
1101110001110111011100001110000111000000000001110000000011101001001111
1100000001110111011100001110000111000000000001110000111000001000000111
1100000000000000000001110000000000000111000000000000111000000010000111
1100000000000000000001110000000011100111111011100000000001110000011111
1110000000111100000000000011110011100000111011100000010001110000011111
1110000111111110000111111111111111000011111100000000111000000000111111
1111111111111111111111111111111111100111111111110111111111100111111111
1111111111111111111111111111111111100111111111111111111111111111111111
