1111111111111111111111111111111111111111111111111111111111111111111111
1111111111111111111111111111111111111111111111111111111111111111111111
1111111111111111111111111111111111111111111111111111111111111111111111
1111111111111011111100101001111111111111111111111111111111111111111111
1111111111110000000000000000001111111001100000000011111111111111111111
1111111100000000000000000000000000000000000000000000000111111111111111
1111110000000010000000000000000000000000000000000000000111111111111111
1111110000000000000000011111000000000001000000000000000000001111111111
1111110000000000000000111111110000000000000000001000000000001111111111
1111110000000000000000111111111000000000000000000000000000000011111111
1111110000000000000001111111111111111111111110000000000000000001111111
1111110001000000011111111111111111111111111111100000000100000000111111
1111110000000000111111111111111111111111111111110000000000000000011111
1111110000000000111111111111111111111111111111111100000000000100001111
1111100000000001111111111111111111111111111111111100000000000000001111
1111000000000001111111111111111111111111111111111110000000000000001111
1111000000000000111111111111111111111111111111111110000000100000011111
1111000000000000111111111111111111111111111111111110000000000000011111
1111000000100000011111111111111111111111111111111100000000000000111111
1111000000000000001111111111111111111111111111111100001000000001111111
1111000000000000000011111111111111111111111111111100000000000000000000
1111000000000000000001111111111111111111111111110000000000000000000000
1111000000000000000000111111111111111100111111100000000000000011111111
1111000000000000000000001110001111111000001110000000000000000001111111
1111000000000000000000000000000011100000000000000000001100000001111111
1111000000100000000000000000000000000000000000000101111111000000001111
1111000000001000000000000000000000001000000000001111111111111000001111
1111000000000000000100000010000000000000000000001111111111111000001111
1111000000000000000000000000000000000000010000001111111111111000000111
1111000001000000000000000000000000000000000000001111111111111000000011
1111001111000000000000000000001100000000000000000111111001100000000011
1111001110000000000000000101111111000000000000000010000000000000000011
1111101510000000000000001111111111111000000000000000000000000000000111
1111100000100000100000001111111111111100000010000000000000000010001111
1111110000000000000000001111111111111110000000000100000000000000011111
1111110000000000000000001111111111111111000000000000000000000000011111
1111111000000000000010000111111111111111000000000000000000000000111111
1111111100000000000000000011111111111111000000000000000000000000111111
1111111100000001000000000000111111111110000000000010000000000001111111
1111111100000000000000000000000011110000000100000000000000000001111111
1111111110000000000000000000000000000000000000000000000000000011111111
1111111110010000000001000000000000000000000000000000000000000011111111
1111111110000000000000000000000000000001000000010000000010000011111111
1111111110000000000000000000000001000000000000000000000000000111111111
1111111111000000000000000000000000000000000000000000000000001111111111
1111111111000000000000000000000000000000000000000000000000011111111111
1111111111000000001111111000000000011111110000000000000000011111111111
1111111111111111111111111111111111111111111111111111111111111111111111
1111111111111111111111111111111111111111111111111111111111111111111111
1111111111111111111111111111111111111111111111111111111111111111111111
