1111111111111111111111111111111111111111111111111111111111111111111111
1000011111111111111111111111111100610011111111111111111100011100010001
1000011111111111111111111111100101001011110000000000000000011100000001
1000011100011111111100011000100100000011110000011111111100011100010001
1000000000000000000000000000000101001011110000010000011110111110111011
1000011100011111111100011000100100000011110000010000011110100010111011
1000011110111111111110111101111101001011111101110000011110100010111011
1000011110111111111110111101111100000010011101110000000000000010111011
1111111110111111111110111101111101001010011000110000011110100010111011
1000001100011110001110111101111100000010000000110000011110111110111011
1000001100000000001110100000111111001110011000110000011100011100010001
1000001100011110001110100000100001001111111101111111111100000000010001
1000001110111111011110100000100001001111111101111111111100011100010001
1101111110111111011110100000100000001111111101110000000110111110111011
1101111110111111011110111111111111001000111000110000000110111110111011
1000111110100100000100011111000011001000000000110000000110111110111011
1010000000000100000100000000000011001000111000110000000100011100010001
1000111110100100000100011111000011001000111101110000000100000000000001
1101111110100100000110111111000011001111111101110000000100011100010001
1000000110111111011110111111111111001111111101111110111110111111111111
1000000110111111011100011001000001001000010001111110111110111111111111
1000000110111111011100000001000001001000010001110010111110111111100001
1111111110111111011100011001000001000000010001110010100100011111100001
1100011100011110001110111001110111001000010001110000000100000000000001
1100000000000000001110111111110111001000011011110010100100011101100001
1100011100011110001110111111110111001111111011111110111110111101100001
1100011111111111011100011111100011001111110001001110111110111101111111
1111111111111111011100000000000000000000000000001000001110111101111111
1111111111111111011100011111100011001111110001001000001100011000100001
1000011000000011011110111111110111001111111111001000000001000000100001
1000011000000011011110111111110111001111111111001000001100011000100001
1000011000000011011110111111110111001111100011111110111110111101100001
1110111000000011011110100011110111001000100011000110111110110000111101
1110111111110111011110100011100011001000100000000110111110110000111101
1110111111110111011110100000000011000000100011000100011100011111000101
1100011111100010001110100011100011001000100011101100000000000000000101
1101000000000000001110100011110111001000111111101100011100011011000101
1100011111100010001110111111110111001111111111101110111110111011101101
1110110000111111011100011111100011001111111111101110111110111011101101
1110110000100001011100000000000000001111111111101000000110111011101101
1110110000100001011100011111100011001111111111101000000110110001101101
1000010000100001011110111111111111001111111111101000000110110001101101
1000011011110111011110111111111111001111111111101111111110110001101101
1000000000000000000000000000000000000000000000000000000000111111101101
1000010000000000000000000000000000000000000000000000000000111111101101
1101111111111011111011110111100000000000011111101111111110111111000001
1000100000110001110001000000100000000000010001101111111110111111000001
1000000000000000000001000000100000000000010000000000000000000000000001
1000100000110001110001000000100000000000010001101010101010111111000001
1111111111111111111111111111111111001111111111111111111111111111111111
